1 maps/map0_2.txt 1 17 
  
TAATWWWWWWWWWWWWWWWWWWWWWWW
PPPPWWWWWWWWWWWWWWWWWWWWWWW
PPPPWWWWWPPPPPPPPPPPPP1PPPP
PPPPWWWWPPPPPPPPPPPPPP1PPPP
PPPPWWWPPPPPPPPPPPPPPP1PPPP
PPPPWWWPPPPPPPPPPPPPPP1PPPP
PPPGGWWPPPPPPWWWWWWWWWWWWWW
PPGGGWWPPPPPWWWWWWWWWWWWWWW
GGGGGGGGGGWWWWWWWWWWWWWWWWW
GGGGGGGGGGWWWWWWWWWWWWWWWWW
GGGGWWWPPPWWWWWWWWWWWWWWWWW
GGGGWWWPPPWWWWWWWWWWWWWWWWW
GGGGWWWPPPWWWWWWWWWWWWWWWWW
PPPPWWPPPPWWWWWWWWWWWWWWWWW
PPPPWPPPPPWWWWWWWWWWWWWWWWW
PPPPPPPPPPWWWWWWWWWWWWWWWWW
PPPPPPPPPWWWWWWWWWWWWWWWWWW
WWWWWWWWWWWWWWWWWWWWWWWWWWW
WWWWWWWWWWWWWWWWWWWWWWWWWWW
WWWWWWWWWWWWWWWWWWWWWWWWWWW
WWWWWWWWWWWWWWWWWWWWWWWWWWW
WWWWWWWWWWWWWWWWWWWWWWWWWWW