0 maps/map0_2.txt 1 0 
  
PPPPPPPWWWWWPPPP0
PPPPPPPWWWWWPPPPP
PPPPPPPWWWWWPPPPP
PPPPPPPWWWWWGPPPG
PPPPPPPWWWWWGPPPG
PPPPPPPGGGGGGPPPG
PPPPPPPPPPPPPPPPG
PPPPPPPPPPPPPPPPG
BBBBBBBGGGGGGGGGG
