doorKey mapName mapX mapY

GGGWWWPP
GGGWWWPP
GGWWWPPP
GWWWWPPP
GWWWPPPP
WWWWPPPP
WWWPPPPP
WWPPPPPP
WPPPPPPP
PPPPPPPP
