0 maps/map0_1.txt 15 0 
1 maps/map0_3.txt 22 5 
  
0PPPPPPPPPPPPPPP
PPPPPPPPPPPPPPP
PPPPPPPPPPPPPP
PPPPPPPPPPPP
PPPPPPPPPP
PPPPPPPP
PPPPPP
PPPPP
PPPP
PP
PPPPPPPPPPPPPPPPPPPPPPPPPPPPPPPPPPPPPPPPPPPPPPPPPPPPPP
PPPPPPPPPPPPPPPPPPPPPPPPPPPPPPPPPPPPPPPPPPPPPPPPPPPPPP
                                       PPPPPPPPPPPPPPP
                                       PPPPPPPPPPPPPPP
                                       PPPPPPPPPPPPPPP
PPPPPPPPPPPPPPPPPPPPPPPPPPPPPPPPPPPPPPPPPPPPPPPPPPPPPP
1PPPPPPPPPPPPPPPPPPPPPPPPPPPPPPPPPPPPPPPPPPPPPPPPPPPPP
PPPPPPPPPPPPPPPPPPPPPPPPPPPPPPPPPPPPPPPPPPPPPPPPPPPPPP
