0 maps/map0_2.txt 1 0 
  
PPPPPPP     PPPP0
PPPPPPP     PPPPP
PPPPPPP     PPPPP
PPPPPPP     GGGGG
PPPPPPP     GGGGG
PPPPPPPGGGGGGGGGG
PPPPPPPGGGGGGGGGG
PPPPPPPGGGGGGGGGG
BBBBBBBGGGGGGGGGG
