0 maps/map0_2.txt 1 0 
  
PPPPPPPWWWWWPPPP0WWTTTTTTTTTTTTTTTTTT
PPPPPPPWWWWWPPPPPWWTTTTTTTTTTTTTTTTTT
PPPPPPPWWWWWPPPPPWWTTTTTTTTTTTTTTTTTT
PPPPPPPWWWWWGPPPGWWTTTTTTTTTTTTTTTTTT
PPPPPPPWWWWWGPPPGWWTTTTTTTTTTTTTTTTTT
PPPPPPPGGGGGGPPPGWWTTTTTTTTTTTTTTTTTT
PPPPPPPPPPPPPPPPGWWTTTTTTTTTTTTTTTTTT
PPPPPPPPPPPPPPPPGWWTTTTTTTTTTTTTTTTTT
BBBBBBBGGGGGGGGGGWWTTTTTTTTTTTTTTTTTT
WWWWWWWWWWWWWWWWWWWTTTTTTTTTTTTTTTTTT
WWWWWWWWWWWWWWWWWWWTTTTTTTTTTTTTTTTTT
TTTTTTTTTTTTTTTTTTTTTTTTTTTTTTTTTTTTT
TTTTTTTTTTTTTTTTTTTTTTTTTTTTTTTTTTTTT
TTTTTTTTTTTTTTTTTTTTTTTTTTTTTTTTTTTTT
TTTTTTTTTTTTTTTTTTTTTTTTTTTTTTTTTTTTT
TTTTTTTTTTTTTTTTTTTTTTTTTTTTTTTTTTTTT
TTTTTTTTTTTTTTTTTTTTTTTTTTTTTTTTTTTTT
TTTTTTTTTTTTTTTTTTTTTTTTTTTTTTTTTTTTT
TTTTTTTTTTTTTTTTTTTTTTTTTTTTTTTTTTTTT
TTTTTTTTTTTTTTTTTTTTTTTTTTTTTTTTTTTTT
TTTTTTTTTTTTTTTTTTTTTTTTTTTTTTTTTTTTT
TTTTTTTTTTTTTTTTTTTTTTTTTTTTTTTTTTTTT