1 maps/map0_2.txt 3 16 
  
TAATWWWWWWWWWWWWWWWWWWWWWWWPPPPP
PPPPWWWWWWPPPPPPPPPWWWWWWWWPPPPP
PPPPWWWWWPPPPPPPPPPPPP111PPPPPPP
PPPPWWWWPPPPPPPPPPPPPP111PPPPPPP
PPPPWWWPPPPPPPPPPPPPPP111PPPPPPP
PPPPWWWPPPPPPWWWWPPPPP111PPPPPPP
PPPGGWWPPPPPWWWWWWPPPPPWWWWWWWWW
PPGGGGWPPPPWWWWWWWWPPPWWWWWWWWWW
GGGGGGGGGGWWWWWWWWWPPPWWWWWWWWWW
GGGGGGGGGWWWWWWWWWWPPWWWWWWWWWWW
GGGGGWWPPWWWWWWWWWWWPWWWWWWWWWWW
GGGGWWWPPWWWWWWWWWWWPWWWWWWWWWWW
GGGGWWWPPWWWWWWWWWWWPWWWWWWWWWWW
PPPPWWPPPWWWWWWWWWWWPWWWWWWWWWWW
PPPPWPPPPPWWWWWWWWWPPWWWWWWWWWWW
PPPPPPPPPPWWWWWWWWWPPWWWWWWWWWWW
PPPPPPPPPPPWWWWWWWPPPPWWWWWWWWWW
PPPPPPPPPPPPWWWWWPPPPPWWWWWWWWWW
PPPPPPPPPPPPPPPPPPPPPWWWWWWWWWWW
WWWWWWWWWWPPPPPPPPPWWWWWWWWWWWWW
WWWWWWWWWWWWPPPPPPWWWWWWWWWWWWWW
WWWWWWWWWWWWWPPPPWWWWWWWWWWWWWWW
WWWWWWWWWWWWWWWWWWWWWWWWWWWWWWWW
WWWWWWWWWWWWWWWWWWWWWWWWWWWWWWWW
WWWWWWWWWWWWWWWWWWWWWWWWWWWWWWWW
WWWWWWWWWWWWWWWWWWWWWWWWWWWWWWWW
WWWWWWWWWWWWWWWWWWWWWWWWWWWWWWWW
WWWWWWWWWWWWWWWWWWWWWWWWWWWWWWWW
WWWWWWWWWWWWWWWWWWWWWWWWWWWWWWWW
WWWWWWWWWWWWWWWWWWWWWWWWWWWWWWWW