0 maps/map0_1.txt 15 0 
1 maps/map0_3.txt 21 3 
  
0PPPPPPPPPPPTTTTTTTTTTTTTTTTTTTTTTTTTTTTTTTTTTTTTTTTTTWWTTTTTTTT
PPPPPPPPPPPTTTTTTTTTTTTTTTTTTTTTTTTTTTTTTTTTTTTTTTTTTTWWTTTTTTTT
PPPPPPPPPPTTGGGGGGGGGGGGGGGGGGGGGGGGGGGGGGGGGGGGGGGGGGWWTTTTTTTT
PPPPPPPPPTTTGTTTTTTTTTTTTTTTTTTTTTTTTTTTTTTTTTTTTTTTTGWWTTTTTTTT
PPPPPPPPTTGGGGGGGGGGGGGGGGGGGGGGGGGGGGGGGGGGGGGGGGGGGGWWTTTTTTTT
PPPPPPPTTGTTTTTTTTTTTTTTTTTTTTTTTTTTTTTTTTTTTTTTTTTTTGWWTTTTTTTT
PPPPPPTTGGGGGGGGGGGGGGGGGGGGGGGGGGGGGGGGGGGGGGGGGGGGGGWWTTTTTTTT
PPPPPTTGTTTTTTTTTTTTTTTTTTTTTTTTTTTTTTTTTTTTTTTTTTTTTGWWTTTTTTTT
PPPPTTGGGGGGGGGGGGGGGGGGGGGGGGGGGGGGGGGGGGGGGGGGGGGGGGWWTTTTTTTT
PPPTTTTTTTTTTTTTTTTTTTTTTTTTTTTTTTTTTTTTTTTTTTTTTTTTTTWWTTTTTTTT
PPPPPPPPPPPPPPPPPPPPPPPPPPPPPPPPPPPPPPPPPPPPPPPPPPPPPPWWTTTTTTTT
PPPPPPPPPPPPPPPPPPPPPPPPPPPPPWWPPWPPPPPPPPPPPPPPPPPPPPWWTTTTTTTT
WWWWWWWWWWWWWWWWWWWWWTGGGTWWWWPTTPWWWWPPPPPPPPPPPPPPPPWWTTTTTTTT
WWWWWWWWWWWWWWWWWWWWWTGGGTTTTTTTTTTTTTTPPPPPPPPPPPPPPPWWTTTTTTTT
WWWWWWWWWWWWWWWWWWWWWTGGGTWWWWPTTPWWWWPPPPPPPPPPPPPPPPWWTTTTTTTT
111PPPPPPPPPPPPPPPPPPPPPPPPPPWWPPWPPPPPPPPPPPPPPPPPPPPWWTTTTTTTT
111PPPPPPPPPPPPPPPPPPPPPPPPPPPPPPPPPPPPPPPPPPPPPPPPPPPWWTTTTTTTT
111PPPPPPPPPPPPPPPPPPPPPPPPPPPPPPPPPPPPPPPPPPPPPPPPPPWWWTTTTTTTT
WWWWWWWWWWWWWWWWWWWWWWWWWWWWWWWWWWWWWWWWWWWWWWWWWWWWWWWWTTTTTTTT
WWWWWWWWWWWWWWWWWWWWWWWWWWWWWWWWWWWWWWWWWWWWWWWWWWWWWWWWTTTTTTTT
TTTTTTTTTTTTTTTTTTTTTTTTTTTTTTTTTTTTTTTTTTTTTTTTTTTTTTTTTTTTTTTT
TTTTTTTTTTTTTTTTTTTTTTTTTTTTTTTTTTTTTTTTTTTTTTTTTTTTTTTTTTTTTTTT
TTTTTTTTTTTTTTTTTTTTTTTTTTTTTTTTTTTTTTTTTTTTTTTTTTTTTTTTTTTTTTTT
TTTTTTTTTTTTTTTTTTTTTTTTTTTTTTTTTTTTTTTTTTTTTTTTTTTTTTTTTTTTTTTT
TTTTTTTTTTTTTTTTTTTTTTTTTTTTTTTTTTTTTTTTTTTTTTTTTTTTTTTTTTTTTTTT
TTTTTTTTTTTTTTTTTTTTTTTTTTTTTTTTTTTTTTTTTTTTTTTTTTTTTTTTTTTTTTTT
TTTTTTTTTTTTTTTTTTTTTTTTTTTTTTTTTTTTTTTTTTTTTTTTTTTTTTTTTTTTTTTT